100 100
1111111111111111111111111111111000000000000000000000000000000000000000000000000000000000000000000000
1000000000000000000100000010001000000000000000000000000000000000000000000000000000000000000000000000
10P0000000000000000100000010001111111000000000000000000000000000000000000000000000000000000000000000
1000000000000000000100000000000000001000000000000000000011111111111111111111110000000000000000000000
1111111111111110000100000011111110001000000000000000000010000000000000000000010000000000000000000000
0000010111111110000101111111110010001000000000000000000011111111111111111000010000000000000000000000
0000010000000000000000000000010010001000000000000000000010000000000000001000010000000000000000000000
0000011111111110000000000000010010001000000000000000000010001111111111111000010000000000000000000000
0000000000000111111111111000010010001000000000000000000010001000000000000000010000000000000000000000
0000111111111000000000001000011110001111111111111111111110001111111111111000010000000000000000000000
0000100000000000100000001000000000000000000000000000000000000000000000000000010000000000000000000000
0000100000000000100111111111111111100011111111111111000111111111111111111111110000000000000000000000
0000100000011111100100000000000000100010000000000001000100010000000000000000010000000000000000000000
0000100000010000000100000010000000100011111111111111000100011111111111111111110000000000000000000000
0000100000011111111100000011111111100000000000000000000100000000000000000000010000000000000000000000
0000100000000000000000000000000000000011111111111111111100011111111111011111110000000000000000000000
0001111111111111111111111111111111000010000000100010000100010000000001000000100000000000000000000000
0001000000000000000000000000011111000010000000100010000100010000000001011110100000000000000000000000
0001000000000000000000000000000001000010000000100010000100010000000001010011100000000000000000000000
0001000000111111111011111111100101000011111111100011111100011111111111010000000000000000000000000000
0001111110000000001000000000100101000000000000000000000000000000000000010000000000000000000000000000
0000000010000000001100000000100101001111111111111111111110001111111111110000000000000000000000000000
0000000010000000000100111111100111001000000000000000000010001000000000000000000000000000000000000000
0000000010000000000100000000000000001111111111111111110011111011110000000000000000000000000000000000
0000000011111000000111111111111111000000000000000000000000000000010000000000000000000000000000000000
0000000000001000000000000000000000001111111111111111111111111111110000000000000000000000000000000000
0000000000001000000111111111111110001000000000000000000000000000000000000000000000000000000000000000
0000000000001000000000000000000000001000000000000000000000000000000000000000000000000000000000000000
0000000000001111111111111111111100001000000000000000000000000000000000000000000000000000000000000000
0000000000000000000000000000000100001000000000000000000000000000000000000000000000000000000000000000
0000000000000000000000000000000100001000000000000000000000000000000000000000000000000000000000000000
0000000000000000000000000000000100001000000000000000000000000000000000000000000000000000000000000000
0000000000000000000000000000000100001000000000000000000000000000000000000000000000000000000000000000
0000000000000000000000000000000100001000000000000000000000000000000000000000000000000000000000000000
0000000000000000000000000000000010010000000000000000000000000000000000000000000000000000000000000000
0000000000000000000000000000000010010000000000000000000000000000000000000000000000000000000000000000
0000000000000000000000000000000010010000000000000000000000000000000000000000000000000000000000000000
0000000000000000000000000000000010010000000000000000000000000000000000000000000000000000000000000000
0000000000000000000000000000000010010000000000000000000000000000000000000000000000000000000000000000
0000000000000000000000000000000010010000000000000000000000000000000000000000000000000000000000000000
0000000000001111111111111111111110011111111111111111111111111111111100000000000000000000000000000000
0000000000001000000000000000000000000000000000000000000000000000000100000000000000000000000000000000
0000000000001000000000000000000000000000000000000000000000000000000100000000000000000000000000000000
0000000000001000000000000000000000000000000000000000000000000000000100000000000000000000000000000000
0000000000001000111000000011111100001111111000111111100011111100000100000000000000000000000000000000
0000000000001000111000000010000100001000000000100000000010000100000100000000000000000000000000000000
0000000000001000111000000010000100001111111000111000000011111100000100000000000000000000000000000000
0000000000001000111000000010000100000000001000100000000010011000000100000000000000000000000000000000
0000000000001000111111110011111100001111111000111111100010001100000100000000000000000000000000000000
0000000000001000000000000000000000000000000000000000000000000000000100000000000000000000000000000000
0000000000001000000000000000000000000000000000000000000000000000000100000000000000000000000000000000
0000000000001111111111111111111111111111111111111111111111111111111100000000000000000000000000000000
0000000000000000000000000000000000000000000000000000000000000000000000000000000000000000000000000000
0000000000000000000000000000000000000000000000000000000000000000000000000000000000000000000000000000
0000000000000000000000000000000000000000000000000000000000000000000000000000000000000000000000000000
0000000000000000000000000000000000000000000000000000000000000000000000000000000000000000000000000000
0000000000000000000000000000000000000000000000000000000000000000000000000000000000000000000000000000
0000000000000000000000000000000000000000000000000000000000000000000000000000000000000000000000000000
0000000000000000000000000000000000000000000000000000000000000000000000000000000000000000000000000000
0000000000000000000000000000000000000000000000000000000000000000000000000000000000000000000000000000
0000000000000000000000000000000000000000000000000000000000000000000000000000000000000000000000000000
0000000000000000000000000000000000000000000000000000000000000000000000000000000000000000000000000000
0000000000000000000000000000000000000000000000000000000000000000000000000000000000000000000000000000
0000000000000000000000000000000000000000000000000000000000000000000000000000000000000000000000000000
0000000000000000000000000000000000000000000000000000000000000000000000000000000000000000000000000000
0000000000000000000000000000000000000000000000000000000000000000000000000000000000000000000000000000
0000000000000000000000000000000000000000000000000000000000000000000000000000000000000000000000000000
0000000000000000000000000000000000000000000000000000000000000000000000000000000000000000000000000000
0000000000000000000000000000000000000000000000000000000000000000000000000000000000000000000000000000
0000000000000000000000000000000000000000000000000000000000000000000000000000000000000000000000000000
0000000000000000000000000000000000000000000000000000000000000000000000000000000000000000000000000000
0000000000000000000000000000000000000000000000000000000000000000000000000000000000000000000000000000
0000000000000000000000000000000000000000000000000000000000000000000000000000000000000000000000000000
0000000000000000000000000000000000000000000000000000000000000000000000000000000000000000000000000000
0000000000000000000000000000000000000000000000000000000000000000000000000000000000000000000000000000
0000000000000000000000000000000000000000000000000000000000000000000000000000000000000000000000000000
0000000000000000000000000000000000000000000000000000000000000000000000000000000000000000000000000000
0000000000000000000000000000000000000000000000000000000000000000000000000000000000000000000000000000
0000000000000000000000000000000000000000000000000000000000000000000000000000000000000000000000000000
0000000000000000000000000000000000000000000000000000000000000000000000000000000000000000000000000000
0000000000000000000000000000000000000000000000000000000000000000000000000000000000000000000000000000
0000000000000000000000000000000000000000000000000000000000000000000000000000000000000000000000000000
0000000000000000000000000000000000000000000000000000000000000000000000000000000000000000000000000000
0000000000000000000000000000000000000000000000000000000000000000000000000000000000000000000000000000
0000000000000000000000000000000000000000000000000000000000000000000000000000000000000000000000000000
0000000000000000000000000000000000000000000000000000000000000000000000000000000000000000000000000000
0000000000000000000000000000000000000000000000000000000000000000000000000000000000000000000000000000
0000000000000000000000000000000000000000000000000000000000000000000000000000000000000000000000000000
0000000000000000000000000000000000000000000000000000000000000000000000000000000000000000000000000000
0000000000000000000000000000000000000000000000000000000000000000000000000000000000000000000000000000
0000000000000000000000000000000000000000000000000000000000000000000000000000000000000000000000000000
0000000000000000000000000000000000000000000000000000000000000000000000000000000000000000000000000000
0000000000000000000000000000000000000000000000000000000000000000000000000000000000000000000000000000
0000000000000000000000000000000000000000000000000000000000000000000000000000000000000000000000000000
0000000000000000000000000000000000000000000000000000000000000000000000000000000000000000000000000000
0000000000000000000000000000000000000000000000000000000000000000000000000000000000000000000000000000
0000000000000000000000000000000000000000000000000000000000000000000000000000000000000000000000000000
0000000000000000000000000000000000000000000000000000000000000000000000000000000000000000000000000000
0000000000000000000000000000000000000000000000000000000000000000000000000000000000000000000000000000
0000000000000000000000000000000000000000000000000000000000000000000000000000000000000000000000000000
